//MAP CONVERTED BY dmm2tgm.py THIS HEADER COMMENT PREVENTS RECONVERSION, DO NOT REMOVE
"ad" = (
/obj/structure/kitchenspike,
/turf/open/floor/plasteel{
	icon_state = "showroomfloor"
	},
/area/crew_quarters/kitchen)
"aq" = (
/obj/effect/turf_decal/siding/wood/corner{
	dir = 1
	},
/turf/open/floor/wood,
/area/crew_quarters/bar)
"br" = (
/obj/structure/closet/secure_closet/freezer/kitchen,
/turf/open/floor/carpet,
/area/crew_quarters/kitchen)
"bu" = (
/obj/machinery/jukebox,
/turf/open/floor/wood,
/area/crew_quarters/bar)
"bG" = (
/obj/machinery/processor,
/turf/open/floor/carpet,
/area/crew_quarters/kitchen)
"bN" = (
/obj/structure/chair/stool/bar{
	pixel_y = 6
	},
/turf/open/floor/wood,
/area/crew_quarters/bar)
"dk" = (
/obj/machinery/door/airlock{
	name = "Bar Storage";
	req_access_txt = "25"
	},
/obj/machinery/door/firedoor/border_only{
	dir = 1
	},
/obj/machinery/door/firedoor/border_only,
/turf/open/floor/wood,
/area/crew_quarters/bar)
"dD" = (
/obj/structure/closet/secure_closet/bar{
	req_access_txt = "25"
	},
/obj/item/gun/ballistic/revolver/russian,
/obj/item/reagent_containers/glass/woodmug,
/obj/item/reagent_containers/glass/woodmug,
/obj/item/reagent_containers/glass/woodmug,
/obj/item/reagent_containers/glass/woodmug,
/obj/item/reagent_containers/glass/woodmug,
/obj/item/reagent_containers/glass/woodmug,
/obj/item/reagent_containers/glass/woodmug,
/obj/item/reagent_containers/glass/woodmug,
/obj/item/reagent_containers/glass/woodmug,
/obj/item/reagent_containers/glass/woodmug,
/obj/effect/turf_decal/siding/wood{
	dir = 4
	},
/turf/open/floor/carpet,
/area/crew_quarters/bar)
"ex" = (
/obj/structure/table/wood,
/obj/item/storage/pill_bottle/dice,
/turf/open/floor/wood,
/area/crew_quarters/bar)
"eW" = (
/obj/effect/turf_decal/siding/wood{
	dir = 1
	},
/turf/open/floor/wood,
/area/crew_quarters/bar)
"gK" = (
/obj/structure/musician/piano,
/turf/open/floor/wood,
/area/crew_quarters/bar)
"it" = (
/obj/structure/disposalpipe/segment{
	dir = 5
	},
/turf/open/floor/wood,
/area/crew_quarters/bar)
"ix" = (
/obj/item/stack/sheet/metal/fifty,
/obj/item/stack/sheet/glass/fifty,
/obj/item/stack/cable_coil,
/obj/item/flashlight/lamp,
/obj/item/flashlight/lamp/green,
/obj/structure/closet/secure_closet/bartender,
/turf/open/floor/wood,
/area/crew_quarters/bar)
"iI" = (
/obj/machinery/vending/dinnerware,
/turf/open/floor/carpet,
/area/crew_quarters/kitchen)
"jI" = (
/obj/structure/sign/plaques/deempisi,
/turf/closed/wall/mineral/wood,
/area/crew_quarters/bar)
"jZ" = (
/obj/machinery/oven,
/turf/open/floor/carpet,
/area/crew_quarters/kitchen)
"kc" = (
/obj/effect/turf_decal/siding/wood,
/obj/structure/table/reinforced,
/obj/item/reagent_containers/food/snacks/mint,
/obj/machinery/door/firedoor/border_only{
	dir = 1
	},
/obj/machinery/door/firedoor/border_only,
/obj/machinery/door/poddoor/shutters/preopen{
	id = "kitchen";
	name = "kitchen shutters"
	},
/turf/open/floor/carpet,
/area/crew_quarters/kitchen)
"ki" = (
/obj/structure/table,
/obj/item/reagent_containers/food/snacks/chipsandsalsa,
/turf/open/floor/carpet,
/area/crew_quarters/kitchen)
"kx" = (
/obj/structure/plasticflaps{
	opacity = 1
	},
/obj/machinery/navbeacon{
	codes_txt = "delivery;dir=2";
	freq = 1400;
	location = "Kitchen"
	},
/turf/open/floor/plasteel,
/area/crew_quarters/kitchen)
"kV" = (
/obj/machinery/door/window/southleft{
	base_state = "left";
	dir = 2;
	icon_state = "left";
	name = "Kitchen Delivery";
	req_access_txt = "28"
	},
/obj/effect/turf_decal/delivery,
/obj/structure/window/reinforced{
	dir = 8
	},
/turf/open/floor/plasteel,
/area/crew_quarters/kitchen)
"lf" = (
/obj/machinery/disposal/bin,
/turf/open/floor/carpet,
/area/crew_quarters/kitchen)
"lp" = (
/obj/effect/turf_decal/siding/wood/corner{
	dir = 4
	},
/turf/open/floor/wood,
/area/crew_quarters/bar)
"lF" = (
/obj/machinery/gibber,
/turf/open/floor/plasteel{
	icon_state = "showroomfloor"
	},
/area/crew_quarters/kitchen)
"mi" = (
/obj/effect/turf_decal/siding/wood{
	dir = 4
	},
/obj/structure/table/wood,
/obj/effect/spawner/lootdrop/randomfood,
/obj/machinery/door/window/westright,
/obj/machinery/door/firedoor/border_only{
	dir = 4
	},
/obj/machinery/door/firedoor/border_only{
	dir = 8
	},
/turf/open/floor/wood,
/area/crew_quarters/kitchen)
"mk" = (
/obj/structure/chair/wood{
	dir = 8
	},
/turf/open/floor/wood,
/area/crew_quarters/bar)
"nP" = (
/obj/machinery/door/airlock/wood/glass,
/obj/machinery/door/firedoor/border_only{
	dir = 1
	},
/obj/machinery/door/firedoor/border_only,
/turf/open/floor/wood,
/area/crew_quarters/bar)
"oo" = (
/obj/structure/window/reinforced{
	dir = 4
	},
/obj/structure/flora/bush,
/turf/open/floor/grass/snow/safe,
/area/crew_quarters/bar)
"oK" = (
/obj/machinery/door/airlock/maintenance{
	name = "Kitchen Maintenance";
	req_access_txt = "28"
	},
/obj/machinery/door/firedoor/border_only{
	dir = 1
	},
/obj/machinery/door/firedoor/border_only,
/turf/open/floor/plasteel{
	icon_state = "showroomfloor"
	},
/area/crew_quarters/kitchen)
"oP" = (
/obj/structure/reagent_dispensers/cooking_oil,
/turf/open/floor/plasteel{
	icon_state = "showroomfloor"
	},
/area/crew_quarters/kitchen)
"oY" = (
/obj/effect/landmark/blobstart,
/obj/item/reagent_containers/food/snacks/khachapuri,
/turf/open/floor/plating,
/area/crew_quarters/bar)
"pq" = (
/obj/structure/table,
/obj/machinery/reagentgrinder/kitchen{
	pixel_y = 6
	},
/turf/open/floor/carpet,
/area/crew_quarters/kitchen)
"qs" = (
/obj/structure/window/reinforced{
	dir = 4
	},
/mob/living/simple_animal/hostile/retaliate/goat/cute{
	desc = "He may be cute, but he's a feisty one!";
	dir = 8;
	name = "Henry"
	},
/turf/open/floor/grass/snow/safe,
/area/crew_quarters/bar)
"qv" = (
/obj/structure/table,
/obj/item/book/manual/chef_recipes,
/obj/item/stack/packageWrap,
/turf/open/floor/carpet,
/area/crew_quarters/kitchen)
"qF" = (
/obj/effect/turf_decal/siding/wood,
/turf/open/floor/wood,
/area/crew_quarters/bar)
"rj" = (
/turf/open/floor/wood{
	icon_state = "wood-broken6"
	},
/area/crew_quarters/bar)
"rN" = (
/obj/structure/sink/kitchen{
	pixel_y = 28
	},
/turf/open/floor/carpet,
/area/crew_quarters/kitchen)
"si" = (
/obj/effect/spawner/structure/window/ice,
/turf/open/floor/plating,
/area/crew_quarters/bar)
"sX" = (
/obj/machinery/vending/wardrobe/chef_wardrobe,
/turf/open/floor/plasteel{
	icon_state = "showroomfloor"
	},
/area/crew_quarters/kitchen)
"tj" = (
/turf/open/floor/wood{
	icon_state = "wood-broken3"
	},
/area/crew_quarters/bar)
"ua" = (
/obj/structure/chair/wood{
	dir = 8
	},
/turf/open/floor/carpet,
/area/crew_quarters/bar)
"ug" = (
/obj/machinery/icecream_vat,
/turf/open/floor/plasteel{
	icon_state = "showroomfloor"
	},
/area/crew_quarters/kitchen)
"um" = (
/turf/open/space/basic,
/area/space)
"uA" = (
/obj/machinery/vending/boozeomat,
/turf/open/floor/wood,
/area/crew_quarters/bar)
"uB" = (
/obj/structure/table/wood,
/obj/machinery/reagentgrinder,
/obj/effect/turf_decal/siding/wood{
	dir = 4
	},
/obj/item/reagent_containers/glass/rag,
/turf/open/floor/carpet,
/area/crew_quarters/bar)
"uP" = (
/obj/effect/turf_decal/siding/wood{
	dir = 4
	},
/obj/structure/table/wood,
/obj/effect/spawner/lootdrop/randomdrink,
/obj/machinery/door/window/westright,
/obj/machinery/door/firedoor/border_only{
	dir = 4
	},
/obj/machinery/door/firedoor/border_only{
	dir = 8
	},
/turf/open/floor/wood,
/area/crew_quarters/kitchen)
"vx" = (
/obj/machinery/button/door{
	id = "kitchen";
	name = "Kitchen Shutters Control";
	pixel_x = -1;
	pixel_y = -24;
	req_access_txt = "28"
	},
/turf/open/floor/carpet,
/area/crew_quarters/kitchen)
"vA" = (
/turf/closed/wall/mineral/wood,
/area/crew_quarters/bar)
"vF" = (
/obj/structure/table/wood,
/obj/item/clothing/head/beanie/red,
/obj/machinery/door/poddoor/shutters/preopen{
	id = "barshutters";
	name = "bar shutters"
	},
/turf/open/floor/wood,
/area/crew_quarters/bar)
"wh" = (
/obj/structure/table/wood,
/obj/item/toy/cards/deck{
	pixel_y = 4
	},
/turf/open/floor/carpet,
/area/crew_quarters/bar)
"wk" = (
/turf/open/floor/grass/snow/safe,
/area/crew_quarters/bar)
"wB" = (
/obj/machinery/door/airlock{
	name = "Theatre Backstage";
	req_access_txt = "46"
	},
/obj/machinery/door/firedoor/border_only{
	dir = 1
	},
/obj/machinery/door/firedoor/border_only,
/turf/open/floor/wood,
/area/crew_quarters/bar)
"xd" = (
/obj/structure/table/wood,
/obj/item/toy/snowball{
	pixel_x = -1;
	pixel_y = 1
	},
/obj/item/toy/snowball{
	pixel_x = 4;
	pixel_y = 3
	},
/obj/item/toy/snowball{
	pixel_x = 3;
	pixel_y = -3
	},
/turf/open/floor/wood,
/area/crew_quarters/bar)
"xp" = (
/mob/living/carbon/monkey{
	name = "Pun Pun"
	},
/turf/open/floor/wood,
/area/crew_quarters/bar)
"xQ" = (
/obj/structure/table/wood,
/obj/item/reagent_containers/food/drinks/shaker,
/obj/item/stack/sheet/metal{
	amount = 50
	},
/obj/item/stack/sheet/glass{
	amount = 50
	},
/obj/item/stack/cable_coil,
/obj/item/toy/figure/bartender,
/obj/effect/turf_decal/siding/wood{
	dir = 4
	},
/turf/open/floor/carpet,
/area/crew_quarters/bar)
"xS" = (
/obj/structure/sign/barsign,
/turf/closed/wall/mineral/wood,
/area/crew_quarters/bar)
"yx" = (
/obj/item/storage/secure/safe{
	pixel_x = 6;
	pixel_y = 27
	},
/turf/open/floor/wood,
/area/crew_quarters/bar)
"yD" = (
/obj/structure/fireplace{
	fuel_added = 1000;
	lit = 1
	},
/turf/open/floor/wood,
/area/crew_quarters/bar)
"yE" = (
/obj/structure/window/reinforced{
	dir = 4
	},
/obj/structure/flora/grass/both,
/turf/open/floor/grass/snow/safe,
/area/crew_quarters/bar)
"yH" = (
/obj/effect/turf_decal/siding/wood,
/obj/structure/table/reinforced,
/obj/item/storage/box/fancy/donut_box,
/obj/machinery/door/firedoor/border_only{
	dir = 1
	},
/obj/machinery/door/firedoor/border_only,
/obj/machinery/door/poddoor/shutters/preopen{
	id = "kitchen";
	name = "kitchen shutters"
	},
/turf/open/floor/carpet,
/area/crew_quarters/kitchen)
"yQ" = (
/obj/machinery/chem_master/condimaster{
	name = "CondiMaster Neo"
	},
/turf/open/floor/plasteel{
	icon_state = "showroomfloor"
	},
/area/crew_quarters/kitchen)
"zi" = (
/obj/structure/table/wood,
/obj/item/reagent_containers/food/snacks/hotcrossbun,
/obj/item/reagent_containers/food/snacks/hotcrossbun{
	pixel_x = 7;
	pixel_y = 4
	},
/obj/item/reagent_containers/food/snacks/hotcrossbun{
	pixel_y = 5
	},
/obj/machinery/door/poddoor/shutters/preopen{
	id = "barshutters";
	name = "bar shutters"
	},
/turf/open/floor/wood,
/area/crew_quarters/bar)
"AR" = (
/obj/structure/table/wood,
/obj/item/reagent_containers/food/snacks/chipsandsalsa,
/turf/open/floor/carpet,
/area/crew_quarters/bar)
"AS" = (
/obj/structure/disposalpipe/segment{
	dir = 1
	},
/obj/machinery/door/airlock/maintenance{
	name = "Bar Maintenance";
	req_access_txt = "12"
	},
/obj/machinery/door/firedoor/border_only{
	dir = 1
	},
/obj/machinery/door/firedoor/border_only,
/turf/open/floor/wood,
/area/crew_quarters/bar)
"Cu" = (
/obj/effect/turf_decal/siding/wood,
/obj/structure/table/reinforced,
/obj/machinery/door/firedoor/border_only{
	dir = 1
	},
/obj/machinery/door/firedoor/border_only,
/obj/machinery/door/poddoor/shutters/preopen{
	id = "kitchen";
	name = "kitchen shutters"
	},
/turf/open/floor/carpet,
/area/crew_quarters/kitchen)
"CB" = (
/turf/closed/wall/mineral/wood,
/area/crew_quarters/kitchen)
"CU" = (
/obj/structure/table/wood,
/turf/open/floor/carpet,
/area/crew_quarters/bar)
"DK" = (
/obj/effect/turf_decal/loading_area,
/turf/open/floor/plasteel{
	icon_state = "showroomfloor"
	},
/area/crew_quarters/kitchen)
"DO" = (
/obj/structure/flora/bush,
/turf/open/floor/grass/snow/safe,
/area/crew_quarters/bar)
"Ep" = (
/obj/structure/table/wood,
/obj/machinery/chem_dispenser/drinks/beer{
	dir = 8
	},
/turf/open/floor/wood,
/area/crew_quarters/bar)
"FN" = (
/obj/effect/turf_decal/siding/wood/corner{
	dir = 8
	},
/turf/open/floor/wood{
	icon_state = "wood-broken3"
	},
/area/crew_quarters/bar)
"FS" = (
/obj/machinery/door/window/southleft{
	base_state = "left";
	dir = 2;
	icon_state = "left";
	name = "Bar Delivery";
	req_access_txt = "25"
	},
/obj/effect/turf_decal/delivery,
/turf/open/floor/plasteel,
/area/crew_quarters/bar)
"Gm" = (
/obj/effect/turf_decal/siding/wood/corner,
/turf/open/floor/wood,
/area/crew_quarters/bar)
"Gy" = (
/obj/structure/table/wood,
/obj/machinery/door/poddoor/shutters/preopen{
	id = "barshutters";
	name = "bar shutters"
	},
/obj/item/storage/box/fancy/cigarettes/cigars/havana{
	pixel_x = -3;
	pixel_y = 9
	},
/obj/item/storage/box/matches,
/turf/open/floor/wood,
/area/crew_quarters/bar)
"Hi" = (
/obj/machinery/smartfridge/drinks,
/turf/open/floor/wood,
/area/crew_quarters/bar)
"Ho" = (
/obj/item/toy/snowball{
	pixel_x = -6;
	pixel_y = -4
	},
/obj/item/toy/snowball{
	pixel_x = 2;
	pixel_y = -5
	},
/obj/item/toy/snowball{
	pixel_x = 6;
	pixel_y = 1
	},
/obj/item/toy/snowball{
	pixel_x = 4;
	pixel_y = 7
	},
/obj/item/toy/snowball{
	pixel_x = -3;
	pixel_y = 8
	},
/obj/item/toy/snowball{
	pixel_x = -7;
	pixel_y = 3
	},
/obj/item/toy/snowball{
	pixel_x = -2;
	pixel_y = 4
	},
/obj/item/toy/snowball{
	pixel_x = 3;
	pixel_y = 3
	},
/obj/item/toy/snowball{
	pixel_x = -2;
	pixel_y = -2
	},
/obj/item/toy/snowball{
	pixel_x = -1;
	pixel_y = 1
	},
/turf/open/floor/grass/snow/safe,
/area/crew_quarters/bar)
"HR" = (
/obj/effect/spawner/lootdrop/mob/kitchen_animal,
/turf/open/floor/plasteel{
	icon_state = "showroomfloor"
	},
/area/crew_quarters/kitchen)
"Ia" = (
/obj/structure/flora/tree/pine,
/turf/open/floor/grass/snow/safe,
/area/crew_quarters/bar)
"Ja" = (
/obj/machinery/food_cart,
/turf/open/floor/carpet,
/area/crew_quarters/kitchen)
"JU" = (
/turf/open/floor/plasteel{
	icon_state = "showroomfloor"
	},
/area/crew_quarters/kitchen)
"JV" = (
/obj/structure/table/wood,
/obj/machinery/chem_dispenser/drinks{
	dir = 8
	},
/turf/open/floor/wood,
/area/crew_quarters/bar)
"Ki" = (
/obj/machinery/door/window/southright{
	name = "Bar Door";
	req_access_txt = "25";
	req_one_access_txt = "25;28"
	},
/turf/open/floor/wood,
/area/crew_quarters/bar)
"KU" = (
/obj/structure/bed,
/turf/open/floor/wood,
/area/crew_quarters/bar)
"LO" = (
/obj/structure/flora/grass/both,
/turf/open/floor/grass/snow/safe,
/area/crew_quarters/bar)
"Me" = (
/obj/structure/table,
/obj/item/reagent_containers/glass/mixbowl{
	pixel_x = 1;
	pixel_y = 3
	},
/obj/item/reagent_containers/food/condiment/enzyme{
	layer = 5
	},
/turf/open/floor/carpet,
/area/crew_quarters/kitchen)
"MS" = (
/obj/effect/turf_decal/siding/wood{
	dir = 8
	},
/turf/open/floor/wood,
/area/crew_quarters/bar)
"MZ" = (
/turf/open/floor/carpet,
/area/crew_quarters/bar)
"Nq" = (
/obj/structure/table/wood,
/obj/machinery/door/poddoor/shutters/preopen{
	id = "barshutters";
	name = "bar shutters"
	},
/obj/item/reagent_containers/food/snacks/vegetariansushislice{
	pixel_x = -10
	},
/obj/item/reagent_containers/food/snacks/vegetariansushislice{
	pixel_x = -4
	},
/obj/item/reagent_containers/food/snacks/vegetariansushislice{
	pixel_x = 2
	},
/obj/item/reagent_containers/food/snacks/vegetariansushislice{
	pixel_x = 8
	},
/turf/open/floor/wood,
/area/crew_quarters/bar)
"Og" = (
/turf/open/floor/carpet,
/area/crew_quarters/kitchen)
"OY" = (
/obj/structure/chair/wood{
	dir = 1
	},
/turf/open/floor/wood,
/area/crew_quarters/bar)
"PW" = (
/obj/structure/window/reinforced{
	dir = 4
	},
/turf/open/floor/grass/snow/safe,
/area/crew_quarters/bar)
"Qq" = (
/obj/structure/sink/kitchen{
	pixel_y = 28
	},
/turf/open/floor/wood,
/area/crew_quarters/bar)
"Qv" = (
/obj/structure/flora/rock/pile/icy,
/turf/open/floor/grass/snow/safe,
/area/crew_quarters/bar)
"QT" = (
/obj/effect/turf_decal/siding/wood,
/obj/structure/table/reinforced,
/obj/item/reagent_containers/food/snacks/buttcinnpieslice,
/obj/machinery/door/firedoor/border_only{
	dir = 1
	},
/obj/machinery/door/firedoor/border_only,
/obj/machinery/door/poddoor/shutters/preopen{
	id = "kitchen";
	name = "kitchen shutters"
	},
/turf/open/floor/carpet,
/area/crew_quarters/kitchen)
"QV" = (
/obj/structure/chair/wood{
	dir = 4
	},
/turf/open/floor/carpet,
/area/crew_quarters/bar)
"QX" = (
/obj/machinery/disposal/bin,
/obj/structure/disposalpipe/trunk{
	dir = 8
	},
/turf/open/floor/wood,
/area/crew_quarters/bar)
"SA" = (
/turf/open/floor/wood{
	icon_state = "wood-broken"
	},
/area/crew_quarters/bar)
"TO" = (
/obj/structure/table/wood,
/obj/machinery/door/poddoor/shutters/preopen{
	id = "barshutters";
	name = "bar shutters"
	},
/turf/open/floor/wood,
/area/crew_quarters/bar)
"TU" = (
/obj/machinery/button/door{
	id = "barshutters";
	name = "Bar Shutters Control";
	pixel_x = 4;
	pixel_y = 24;
	req_access_txt = "25"
	},
/obj/machinery/disposal/bin,
/turf/open/floor/wood,
/area/crew_quarters/bar)
"TV" = (
/obj/structure/table/wood,
/obj/item/reagent_containers/glass/woodmug,
/turf/open/floor/carpet,
/area/crew_quarters/bar)
"UR" = (
/obj/structure/closet/secure_closet/freezer/fridge,
/turf/open/floor/carpet,
/area/crew_quarters/kitchen)
"UU" = (
/obj/item/flashlight/lantern,
/turf/open/floor/grass/snow/safe,
/area/crew_quarters/bar)
"VA" = (
/obj/effect/turf_decal/siding/wood{
	dir = 4
	},
/turf/open/floor/wood,
/area/crew_quarters/bar)
"Wl" = (
/obj/structure/closet/secure_closet/freezer/meat,
/obj/item/toy/figure/chef,
/turf/open/floor/plasteel{
	icon_state = "showroomfloor"
	},
/area/crew_quarters/kitchen)
"Wx" = (
/obj/structure/table,
/obj/item/reagent_containers/food/condiment/saltshaker{
	pixel_x = -8;
	pixel_y = 4
	},
/obj/item/reagent_containers/food/condiment/peppermill{
	pixel_x = -3;
	pixel_y = 8
	},
/obj/item/reagent_containers/food/condiment/cinnamon,
/obj/item/kitchen/rollingpin{
	pixel_x = 10;
	pixel_y = -3
	},
/turf/open/floor/carpet,
/area/crew_quarters/kitchen)
"WF" = (
/obj/structure/reagent_dispensers/beerkeg,
/obj/effect/turf_decal/siding/wood{
	dir = 4
	},
/turf/open/floor/carpet,
/area/crew_quarters/bar)
"WV" = (
/obj/structure/table,
/obj/machinery/microwave{
	pixel_x = -3;
	pixel_y = 6
	},
/turf/open/floor/carpet,
/area/crew_quarters/kitchen)
"WY" = (
/obj/effect/turf_decal/siding/wood{
	dir = 4
	},
/obj/machinery/door/airlock{
	name = "Kitchen";
	req_access_txt = "28"
	},
/obj/machinery/door/firedoor/border_only{
	dir = 8
	},
/obj/machinery/door/firedoor/border_only{
	dir = 4
	},
/turf/open/floor/wood,
/area/crew_quarters/kitchen)
"Xd" = (
/obj/machinery/vending/wardrobe/bar_wardrobe,
/turf/open/floor/wood,
/area/crew_quarters/bar)
"XT" = (
/obj/machinery/griddle,
/turf/open/floor/carpet,
/area/crew_quarters/kitchen)
"XU" = (
/obj/machinery/deepfryer,
/turf/open/floor/carpet,
/area/crew_quarters/kitchen)
"YD" = (
/obj/structure/table,
/obj/machinery/microwave{
	pixel_x = -3;
	pixel_y = 6
	},
/obj/effect/spawner/lootdrop/donkpockets{
	pixel_x = -8;
	pixel_y = 7
	},
/obj/effect/spawner/lootdrop/donkpockets{
	pixel_x = 6;
	pixel_y = -6
	},
/turf/open/floor/carpet,
/area/crew_quarters/kitchen)
"YJ" = (
/obj/machinery/door/airlock{
	name = "Kitchen cold room";
	req_access_txt = "28"
	},
/obj/machinery/door/firedoor/border_only{
	dir = 1
	},
/obj/machinery/door/firedoor/border_only,
/turf/open/floor/plasteel{
	icon_state = "showroomfloor"
	},
/area/crew_quarters/kitchen)
"YX" = (
/turf/open/floor/wood,
/area/crew_quarters/bar)

(1,1,1) = {"
um
um
um
um
um
um
um
um
um
um
um
um
um
um
um
um
um
um
um
um
um
um
um
um
um
um
um
um
um
um
um
um
um
um
um
um
um
um
um
um
um
um
um
um
um
um
um
um
um
um
"}
(2,1,1) = {"
um
um
um
um
um
um
um
um
um
um
um
um
um
um
um
um
um
um
um
um
um
um
um
um
um
um
um
um
um
um
um
um
um
um
um
um
um
um
um
um
um
um
um
um
um
um
um
um
um
um
"}
(3,1,1) = {"
um
um
um
um
um
um
um
um
um
um
um
um
um
um
um
um
um
um
um
um
um
um
um
um
um
um
um
um
um
um
um
um
um
um
um
um
um
um
um
um
um
um
um
um
um
um
um
um
um
um
"}
(4,1,1) = {"
um
um
um
um
um
um
um
um
um
um
um
um
um
um
um
um
um
um
um
um
um
um
um
um
um
um
um
um
um
um
um
um
um
um
um
um
um
um
um
um
um
um
um
um
um
um
um
um
um
um
"}
(5,1,1) = {"
um
um
um
um
um
um
um
um
um
um
um
um
um
um
um
um
um
um
um
um
um
um
um
um
um
um
um
um
um
um
um
um
um
um
um
um
um
um
um
um
um
um
um
um
um
um
um
um
um
um
"}
(6,1,1) = {"
um
um
um
um
um
um
um
um
um
um
um
um
um
um
um
um
um
um
um
um
um
um
um
um
um
um
um
um
um
um
um
um
um
um
um
um
um
um
um
um
um
um
um
um
um
um
um
um
um
um
"}
(7,1,1) = {"
um
um
um
um
um
um
um
um
um
um
um
um
um
um
um
um
um
um
um
um
um
um
um
um
um
um
um
um
um
um
um
um
um
um
um
um
um
um
um
um
um
um
um
um
um
um
um
um
um
um
"}
(8,1,1) = {"
um
um
um
um
um
um
um
um
um
um
um
um
um
um
um
um
um
um
um
um
um
um
um
um
um
um
um
um
um
um
um
um
um
um
um
um
um
um
um
um
um
um
um
um
um
um
um
um
um
um
"}
(9,1,1) = {"
um
um
um
um
um
um
um
um
um
um
um
um
um
um
um
um
um
um
vA
vA
si
si
vA
vA
si
vA
vA
si
si
vA
vA
um
um
um
um
um
um
um
um
um
um
um
um
um
um
um
um
um
um
um
"}
(10,1,1) = {"
um
um
um
um
um
um
um
um
um
um
um
um
um
um
um
um
um
um
vA
Ho
wk
wk
Ia
UU
wk
DO
LO
wk
Ia
Qv
vA
um
um
um
um
um
um
um
um
um
um
um
um
um
um
um
um
um
um
um
"}
(11,1,1) = {"
um
um
um
um
um
um
um
um
um
um
um
um
um
um
um
um
um
vA
vA
PW
yE
PW
qs
oo
PW
PW
PW
PW
PW
PW
vA
um
um
um
um
um
um
um
um
um
um
um
um
um
um
um
um
um
um
um
"}
(12,1,1) = {"
um
um
um
um
um
um
um
um
um
um
um
um
um
um
um
um
um
vA
bu
YX
YX
YX
YX
YX
YX
YX
YX
rj
YX
gK
vA
um
um
um
um
um
um
um
um
um
um
um
um
um
um
um
um
um
um
um
"}
(13,1,1) = {"
um
um
um
um
um
um
um
um
um
um
um
um
um
um
um
um
um
wB
YX
YX
Gm
VA
VA
VA
VA
VA
VA
VA
lp
mk
vA
um
um
um
um
um
um
um
um
um
um
um
um
um
um
um
um
um
um
um
"}
(14,1,1) = {"
um
um
um
um
um
um
um
um
um
um
um
um
um
um
um
um
um
vA
YX
YX
qF
QV
QV
QV
MZ
QV
QV
QV
eW
YX
nP
um
um
um
um
um
um
um
um
um
um
um
um
um
um
um
um
um
um
um
"}
(15,1,1) = {"
um
um
um
um
um
um
um
um
um
um
um
um
um
um
um
um
um
vA
yD
YX
qF
CU
wh
TV
MZ
CU
AR
CU
eW
YX
si
um
um
um
um
um
um
um
um
um
um
um
um
um
um
um
um
um
um
um
"}
(16,1,1) = {"
um
um
um
um
um
um
um
um
um
um
um
um
um
um
um
um
um
vA
xd
OY
qF
TV
CU
CU
MZ
CU
TV
CU
eW
YX
nP
um
um
um
um
um
um
um
um
um
um
um
um
um
um
um
um
um
um
um
"}
(17,1,1) = {"
um
um
um
um
um
um
um
um
um
um
um
um
um
um
um
um
um
vA
ex
OY
qF
ua
ua
ua
MZ
ua
ua
ua
eW
YX
xS
um
um
um
um
um
um
um
um
um
um
um
um
um
um
um
um
um
um
um
"}
(18,1,1) = {"
um
um
um
um
um
um
um
um
um
um
um
um
um
um
um
um
um
AS
it
YX
FN
MS
MS
MS
MS
MS
MS
MS
aq
YX
vA
um
um
um
um
um
um
um
um
um
um
um
um
um
um
um
um
um
um
um
"}
(19,1,1) = {"
um
um
um
um
um
um
um
um
um
um
um
um
um
um
um
um
um
vA
QX
YX
YX
YX
bN
bN
bN
bN
bN
bN
YX
YX
vA
um
um
um
um
um
um
um
um
um
um
um
um
um
um
um
um
um
um
um
"}
(20,1,1) = {"
um
um
um
um
um
um
um
um
um
um
um
um
um
um
um
um
um
vA
vA
vA
vA
jI
vA
Nq
vF
Gy
zi
TO
YX
YX
vA
um
um
um
um
um
um
um
um
um
um
um
um
um
um
um
um
um
um
um
"}
(21,1,1) = {"
um
um
um
um
um
um
um
um
um
um
um
um
um
um
um
um
um
xQ
uB
WF
dD
vA
TU
YX
YX
YX
YX
TO
YX
YX
vA
um
um
um
um
um
um
um
um
um
um
um
um
um
um
um
um
um
um
um
"}
(22,1,1) = {"
um
um
um
um
um
um
um
um
um
um
um
um
um
um
um
um
um
YX
YX
YX
YX
dk
YX
YX
xp
YX
YX
Ki
YX
SA
vA
um
um
um
um
um
um
um
um
um
um
um
um
um
um
um
um
um
um
um
"}
(23,1,1) = {"
um
um
um
um
um
um
um
um
um
um
um
um
um
um
um
um
um
Qq
YX
YX
Xd
vA
Ep
JV
tj
uA
YX
Hi
YX
YX
vA
um
um
um
um
um
um
um
um
um
um
um
um
um
um
um
um
um
um
um
"}
(24,1,1) = {"
um
um
um
um
um
um
um
um
um
um
um
um
um
um
um
um
um
vA
yx
KU
vA
vA
CB
CB
uP
CB
mi
CB
WY
CB
CB
um
um
um
um
um
um
um
um
um
um
um
um
um
um
um
um
um
um
um
"}
(25,1,1) = {"
um
um
um
um
um
um
um
um
um
um
um
um
um
um
um
um
um
FS
YX
ix
vA
oY
CB
iI
Og
Og
Og
Og
Og
CB
um
um
um
um
um
um
um
um
um
um
um
um
um
um
um
um
um
um
um
um
"}
(26,1,1) = {"
um
um
um
um
um
um
um
um
um
um
um
um
um
um
um
um
um
CB
CB
CB
CB
CB
CB
Ja
Og
Og
Og
Og
Og
CB
um
um
um
um
um
um
um
um
um
um
um
um
um
um
um
um
um
um
um
um
"}
(27,1,1) = {"
um
um
um
um
um
um
um
um
um
um
um
um
um
um
um
um
um
CB
Wl
ug
ad
ad
CB
rN
Og
ki
XT
Og
Og
yH
um
um
um
um
um
um
um
um
um
um
um
um
um
um
um
um
um
um
um
um
"}
(28,1,1) = {"
um
um
um
um
um
um
um
um
um
um
um
um
um
um
um
um
um
oK
JU
JU
JU
JU
YJ
Og
Og
Me
XU
Og
Og
kc
um
um
um
um
um
um
um
um
um
um
um
um
um
um
um
um
um
um
um
um
"}
(29,1,1) = {"
um
um
um
um
um
um
um
um
um
um
um
um
um
um
um
um
um
CB
oP
yQ
HR
JU
CB
UR
Og
Wx
XU
Og
Og
QT
um
um
um
um
um
um
um
um
um
um
um
um
um
um
um
um
um
um
um
um
"}
(30,1,1) = {"
um
um
um
um
um
um
um
um
um
um
um
um
um
um
um
um
um
kx
kV
DK
JU
JU
CB
WV
Og
qv
jZ
Og
Og
Cu
um
um
um
um
um
um
um
um
um
um
um
um
um
um
um
um
um
um
um
um
"}
(31,1,1) = {"
um
um
um
um
um
um
um
um
um
um
um
um
um
um
um
um
um
CB
CB
CB
sX
lF
CB
YD
Og
Og
Og
Og
vx
CB
um
um
um
um
um
um
um
um
um
um
um
um
um
um
um
um
um
um
um
um
"}
(32,1,1) = {"
um
um
um
um
um
um
um
um
um
um
um
um
um
um
um
um
um
um
um
CB
CB
CB
CB
br
Og
Og
bG
pq
lf
CB
um
um
um
um
um
um
um
um
um
um
um
um
um
um
um
um
um
um
um
um
"}
(33,1,1) = {"
um
um
um
um
um
um
um
um
um
um
um
um
um
um
um
um
um
um
um
um
um
um
CB
CB
CB
CB
CB
CB
CB
CB
um
um
um
um
um
um
um
um
um
um
um
um
um
um
um
um
um
um
um
um
"}
(34,1,1) = {"
um
um
um
um
um
um
um
um
um
um
um
um
um
um
um
um
um
um
um
um
um
um
um
um
um
um
um
um
um
um
um
um
um
um
um
um
um
um
um
um
um
um
um
um
um
um
um
um
um
um
"}
(35,1,1) = {"
um
um
um
um
um
um
um
um
um
um
um
um
um
um
um
um
um
um
um
um
um
um
um
um
um
um
um
um
um
um
um
um
um
um
um
um
um
um
um
um
um
um
um
um
um
um
um
um
um
um
"}
(36,1,1) = {"
um
um
um
um
um
um
um
um
um
um
um
um
um
um
um
um
um
um
um
um
um
um
um
um
um
um
um
um
um
um
um
um
um
um
um
um
um
um
um
um
um
um
um
um
um
um
um
um
um
um
"}
(37,1,1) = {"
um
um
um
um
um
um
um
um
um
um
um
um
um
um
um
um
um
um
um
um
um
um
um
um
um
um
um
um
um
um
um
um
um
um
um
um
um
um
um
um
um
um
um
um
um
um
um
um
um
um
"}
(38,1,1) = {"
um
um
um
um
um
um
um
um
um
um
um
um
um
um
um
um
um
um
um
um
um
um
um
um
um
um
um
um
um
um
um
um
um
um
um
um
um
um
um
um
um
um
um
um
um
um
um
um
um
um
"}
(39,1,1) = {"
um
um
um
um
um
um
um
um
um
um
um
um
um
um
um
um
um
um
um
um
um
um
um
um
um
um
um
um
um
um
um
um
um
um
um
um
um
um
um
um
um
um
um
um
um
um
um
um
um
um
"}
(40,1,1) = {"
um
um
um
um
um
um
um
um
um
um
um
um
um
um
um
um
um
um
um
um
um
um
um
um
um
um
um
um
um
um
um
um
um
um
um
um
um
um
um
um
um
um
um
um
um
um
um
um
um
um
"}
(41,1,1) = {"
um
um
um
um
um
um
um
um
um
um
um
um
um
um
um
um
um
um
um
um
um
um
um
um
um
um
um
um
um
um
um
um
um
um
um
um
um
um
um
um
um
um
um
um
um
um
um
um
um
um
"}
(42,1,1) = {"
um
um
um
um
um
um
um
um
um
um
um
um
um
um
um
um
um
um
um
um
um
um
um
um
um
um
um
um
um
um
um
um
um
um
um
um
um
um
um
um
um
um
um
um
um
um
um
um
um
um
"}
(43,1,1) = {"
um
um
um
um
um
um
um
um
um
um
um
um
um
um
um
um
um
um
um
um
um
um
um
um
um
um
um
um
um
um
um
um
um
um
um
um
um
um
um
um
um
um
um
um
um
um
um
um
um
um
"}
(44,1,1) = {"
um
um
um
um
um
um
um
um
um
um
um
um
um
um
um
um
um
um
um
um
um
um
um
um
um
um
um
um
um
um
um
um
um
um
um
um
um
um
um
um
um
um
um
um
um
um
um
um
um
um
"}
(45,1,1) = {"
um
um
um
um
um
um
um
um
um
um
um
um
um
um
um
um
um
um
um
um
um
um
um
um
um
um
um
um
um
um
um
um
um
um
um
um
um
um
um
um
um
um
um
um
um
um
um
um
um
um
"}
(46,1,1) = {"
um
um
um
um
um
um
um
um
um
um
um
um
um
um
um
um
um
um
um
um
um
um
um
um
um
um
um
um
um
um
um
um
um
um
um
um
um
um
um
um
um
um
um
um
um
um
um
um
um
um
"}
(47,1,1) = {"
um
um
um
um
um
um
um
um
um
um
um
um
um
um
um
um
um
um
um
um
um
um
um
um
um
um
um
um
um
um
um
um
um
um
um
um
um
um
um
um
um
um
um
um
um
um
um
um
um
um
"}
(48,1,1) = {"
um
um
um
um
um
um
um
um
um
um
um
um
um
um
um
um
um
um
um
um
um
um
um
um
um
um
um
um
um
um
um
um
um
um
um
um
um
um
um
um
um
um
um
um
um
um
um
um
um
um
"}
(49,1,1) = {"
um
um
um
um
um
um
um
um
um
um
um
um
um
um
um
um
um
um
um
um
um
um
um
um
um
um
um
um
um
um
um
um
um
um
um
um
um
um
um
um
um
um
um
um
um
um
um
um
um
um
"}
(50,1,1) = {"
um
um
um
um
um
um
um
um
um
um
um
um
um
um
um
um
um
um
um
um
um
um
um
um
um
um
um
um
um
um
um
um
um
um
um
um
um
um
um
um
um
um
um
um
um
um
um
um
um
um
"}
