//MAP CONVERTED BY dmm2tgm.py THIS HEADER COMMENT PREVENTS RECONVERSION, DO NOT REMOVE
"aa" = (
/obj/structure/table/wood,
/obj/item/storage/crayons{
	pixel_x = -3;
	pixel_y = 8
	},
/obj/item/storage/crayons{
	pixel_x = 2
	},
/obj/machinery/light,
/turf/open/floor/wood,
/area/survivalpod)
"ac" = (
/obj/structure/window/reinforced/clockwork/fulltile,
/turf/open/floor/clockwork/reebe,
/area/survivalpod)
"ad" = (
/turf/open/floor/mineral/bananium,
/area/survivalpod)
"ax" = (
/obj/structure/table/abductor,
/obj/item/paper/guides/antag/abductor,
/obj/structure/window/paperframe,
/turf/open/floor/plating/abductor,
/area/survivalpod)
"aI" = (
/obj/structure/alien/weeds/node,
/obj/structure/alien/resin/wall,
/obj/structure/alien/weeds,
/obj/structure/alien/weeds,
/turf/open/floor/grass/fakebasalt,
/area/survivalpod)
"bd" = (
/obj/structure/table/bananium,
/obj/structure/window/plasma/reinforced{
	dir = 8
	},
/obj/structure/table/bananium,
/obj/structure/window/plasma/reinforced{
	dir = 1
	},
/obj/item/clothing/shoes/clown_shoes/banana_shoes,
/turf/open/floor/mineral/bananium,
/area/survivalpod)
"bg" = (
/obj/item/aicard,
/obj/machinery/light/floor,
/turf/open/floor/circuit/green,
/area/survivalpod)
"bh" = (
/obj/effect/turf_decal/siding/wood,
/turf/open/floor/carpet,
/area/survivalpod)
"bp" = (
/obj/effect/turf_decal/siding/wood,
/obj/structure/bookcase/random/reference,
/turf/open/floor/carpet,
/area/survivalpod)
"bq" = (
/obj/structure/destructible/cult/talisman,
/turf/open/floor/mineral/plastitanium/red,
/area/survivalpod)
"bE" = (
/mob/living/simple_animal/cheese,
/turf/open/floor/carpet/orange,
/area/survivalpod)
"cy" = (
/obj/structure/reagent_dispensers/watertank,
/obj/effect/turf_decal/tile/red{
	dir = 1
	},
/obj/effect/turf_decal/tile/red{
	dir = 4
	},
/obj/effect/turf_decal/tile/red,
/obj/effect/turf_decal/tile/red{
	dir = 8
	},
/turf/open/floor/white,
/area/survivalpod)
"cO" = (
/turf/closed/wall/r_wall,
/area/survivalpod)
"dg" = (
/obj/structure/easel,
/obj/item/canvas/twentythreeXnineteen,
/turf/open/floor/wood,
/area/survivalpod)
"dr" = (
/obj/item/grown/bananapeel,
/turf/open/floor/mineral/bananium,
/area/survivalpod)
"dB" = (
/obj/structure/table/wood,
/obj/item/storage/pill_bottle/dice,
/obj/machinery/light,
/turf/open/floor/wood,
/area/survivalpod)
"dZ" = (
/obj/machinery/door/airlock/gold,
/turf/open/floor/carpet/orange,
/area/survivalpod)
"em" = (
/obj/effect/decal/cleanable/blood/tracks{
	dir = 8
	},
/turf/open/floor/plating/abductor,
/area/survivalpod)
"eA" = (
/obj/item/clothing/head/bearpelt,
/obj/item/reagent_containers/food/snacks/meat/slab/bear,
/obj/item/reagent_containers/food/snacks/meat/slab/bear,
/obj/item/reagent_containers/food/snacks/meat/slab/bear,
/obj/item/reagent_containers/food/snacks/meat/slab/bear,
/obj/effect/decal/cleanable/blood,
/turf/open/floor/grass/snow,
/area/survivalpod)
"eC" = (
/obj/item/paper/fluff/ruins/djstation{
	name = "paper - 'Station Radio Frequencies'"
	},
/turf/closed/wall/mineral/gold,
/area/survivalpod)
"eU" = (
/obj/structure/window/reinforced{
	dir = 8
	},
/obj/effect/decal/remains/human,
/turf/open/floor/mineral/plastitanium/red,
/area/survivalpod)
"fn" = (
/obj/effect/turf_decal/tile/yellow,
/obj/effect/turf_decal/tile/yellow{
	dir = 1
	},
/obj/effect/turf_decal/tile/yellow{
	dir = 4
	},
/obj/effect/turf_decal/tile/yellow{
	dir = 8
	},
/obj/effect/turf_decal/tile/yellow{
	dir = 8
	},
/obj/effect/turf_decal/tile/yellow{
	dir = 8
	},
/obj/effect/turf_decal/tile/yellow{
	dir = 4
	},
/obj/effect/turf_decal/tile/yellow{
	dir = 4
	},
/obj/structure/table/wood/fancy/royalblack,
/obj/item/reagent_containers/food/drinks/trophy/bronze_cup{
	pixel_x = -3;
	pixel_y = 12
	},
/obj/item/reagent_containers/food/drinks/trophy{
	pixel_x = 7;
	pixel_y = 12
	},
/turf/open/floor/noslip,
/area/survivalpod)
"fE" = (
/obj/item/reagent_containers/food/drinks/beer,
/turf/open/floor/wood,
/area/survivalpod)
"fK" = (
/turf/open/floor/mineral/plastitanium/red,
/area/survivalpod)
"fW" = (
/obj/effect/spawner/lootdrop/clockcult,
/obj/structure/chair/brass{
	dir = 1
	},
/turf/open/floor/clockwork/reebe,
/area/survivalpod)
"gb" = (
/obj/structure/window/reinforced{
	dir = 8
	},
/obj/effect/rune/summon,
/turf/open/floor/mineral/plastitanium/red,
/area/survivalpod)
"gd" = (
/obj/structure/table/wood/fancy,
/obj/item/reagent_containers/food/snacks/store/cheesewheel/american,
/obj/machinery/light,
/turf/open/floor/carpet/orange,
/area/survivalpod)
"gm" = (
/obj/machinery/light{
	dir = 1
	},
/turf/open/floor/mineral/plastitanium/red,
/area/survivalpod)
"gA" = (
/turf/open/floor/grass/fairy/green,
/area/survivalpod)
"hg" = (
/obj/effect/mob_spawn/human/plasmaman,
/obj/machinery/light{
	dir = 1
	},
/turf/open/floor/mineral/plasma,
/area/survivalpod)
"hh" = (
/obj/structure/destructible/cult/forge,
/turf/open/floor/mineral/plastitanium/red,
/area/survivalpod)
"ho" = (
/obj/structure/chair/brass{
	dir = 1
	},
/turf/open/floor/clockwork/reebe,
/area/survivalpod)
"hE" = (
/obj/structure/noticeboard{
	pixel_y = 32
	},
/obj/machinery/light{
	dir = 1
	},
/turf/open/floor/clockwork/reebe,
/area/survivalpod)
"hQ" = (
/turf/open/floor/wood,
/area/survivalpod)
"hY" = (
/obj/effect/rune/raise_dead,
/turf/open/floor/mineral/plastitanium/red,
/area/survivalpod)
"ix" = (
/obj/effect/turf_decal/tile/yellow,
/obj/effect/turf_decal/tile/yellow{
	dir = 1
	},
/obj/effect/turf_decal/tile/yellow{
	dir = 4
	},
/obj/effect/turf_decal/tile/yellow{
	dir = 8
	},
/obj/effect/turf_decal/tile/yellow{
	dir = 8
	},
/obj/effect/turf_decal/tile/yellow{
	dir = 8
	},
/obj/effect/turf_decal/tile/yellow{
	dir = 4
	},
/obj/effect/turf_decal/tile/yellow{
	dir = 4
	},
/obj/machinery/light/floor,
/turf/open/floor/noslip,
/area/survivalpod)
"jb" = (
/turf/open/floor/plating/abductor,
/area/survivalpod)
"jO" = (
/obj/structure/bed/nest,
/obj/structure/alien/weeds,
/turf/open/floor/grass/fakebasalt,
/area/survivalpod)
"kc" = (
/obj/structure/destructible/cult/tome,
/turf/open/floor/mineral/plastitanium/red,
/area/survivalpod)
"kz" = (
/obj/structure/alien/weeds/node,
/obj/structure/alien/egg/burst,
/obj/structure/alien/weeds,
/turf/open/floor/grass/fakebasalt,
/area/survivalpod)
"kG" = (
/obj/machinery/light{
	dir = 8
	},
/turf/open/floor/grass/fairy/green,
/area/survivalpod)
"kX" = (
/obj/item/grown/bananapeel,
/obj/machinery/door/airlock/bananium,
/turf/open/floor/mineral/bananium,
/area/survivalpod)
"nf" = (
/obj/structure/reagent_dispensers/watertank,
/turf/open/floor/carpet/cyan,
/area/survivalpod)
"no" = (
/obj/structure/flora/rock,
/turf/open/floor/grass/snow,
/area/survivalpod)
"nt" = (
/obj/effect/spawner/structure/window/bananium,
/turf/open/floor/mineral/bananium,
/area/survivalpod)
"nL" = (
/obj/structure/table/wood/fancy,
/obj/item/reagent_containers/food/snacks/cheesewedge/feta{
	pixel_x = 7;
	pixel_y = -3
	},
/obj/item/reagent_containers/food/snacks/cheesewedge/american,
/obj/item/reagent_containers/food/snacks/cheesewedge/goat{
	pixel_x = -3;
	pixel_y = 8
	},
/turf/open/floor/carpet/orange,
/area/survivalpod)
"nU" = (
/obj/machinery/door/airlock/public/glass{
	name = "Central Access"
	},
/turf/open/floor/grass/snow,
/area/survivalpod)
"oh" = (
/obj/machinery/status_display/ai_core,
/turf/open/floor/circuit/green,
/area/survivalpod)
"oF" = (
/obj/machinery/door/window/southleft{
	dir = 8;
	name = "Core Modules"
	},
/obj/effect/spawner/lootdrop/aimodule_harmless,
/obj/effect/spawner/lootdrop/aimodule_neutral,
/turf/open/floor/circuit/green,
/area/survivalpod)
"oS" = (
/turf/open/floor/carpet/orange,
/area/survivalpod)
"oV" = (
/obj/effect/spawner/structure/window/reinforced,
/obj/effect/turf_decal/tile/red{
	dir = 1
	},
/obj/effect/turf_decal/tile/red{
	dir = 4
	},
/obj/effect/turf_decal/tile/red{
	dir = 8
	},
/obj/effect/turf_decal/tile/red,
/turf/open/floor/white,
/area/survivalpod)
"pA" = (
/obj/structure/alien/weeds/node,
/obj/structure/alien/resin/membrane,
/obj/structure/alien/weeds,
/turf/open/floor/grass/fakebasalt,
/area/survivalpod)
"pH" = (
/obj/machinery/computer/upload/ai{
	dir = 8
	},
/turf/open/floor/circuit/green,
/area/survivalpod)
"pV" = (
/obj/effect/decal/remains/human,
/turf/open/floor/plating/abductor,
/area/survivalpod)
"pY" = (
/obj/effect/decal/cleanable/blood/gibs/limb{
	pixel_x = -8;
	pixel_y = -1
	},
/turf/open/floor/plating/abductor,
/area/survivalpod)
"qe" = (
/obj/structure/alien/egg/burst,
/obj/structure/alien/weeds,
/turf/open/floor/grass/fakebasalt,
/area/survivalpod)
"qw" = (
/obj/effect/decal/cleanable/blood/tracks,
/turf/open/floor/plating/abductor,
/area/survivalpod)
"rc" = (
/obj/machinery/light/small{
	dir = 1
	},
/turf/open/floor/wood,
/area/survivalpod)
"rl" = (
/obj/effect/decal/cleanable/blood,
/turf/open/floor/grass/snow,
/area/survivalpod)
"rP" = (
/obj/structure/statue/cheese/cheesus,
/turf/open/floor/carpet/orange,
/area/survivalpod)
"rS" = (
/obj/machinery/portable_atmospherics/canister/oxygen,
/turf/open/floor/mineral/plasma,
/area/survivalpod)
"rV" = (
/obj/machinery/light{
	dir = 4
	},
/turf/open/floor/grass/fairy/green,
/area/survivalpod)
"si" = (
/obj/structure/bed,
/obj/item/bedsheet/red,
/turf/open/floor/wood,
/area/survivalpod)
"sC" = (
/obj/effect/overlay/palmtree_r,
/turf/open/floor/grass/fairy/green,
/area/survivalpod)
"sG" = (
/obj/effect/spawner/lootdrop/clockcult,
/turf/open/floor/clockwork/reebe,
/area/survivalpod)
"sO" = (
/obj/effect/decal/cleanable/blood/tracks{
	dir = 5
	},
/turf/open/floor/plating/abductor,
/area/survivalpod)
"sR" = (
/obj/structure/table/bananium,
/obj/structure/window/plasma/reinforced{
	dir = 4
	},
/obj/structure/window/plasma/reinforced{
	dir = 1
	},
/obj/item/reagent_containers/spray/waterflower/lube,
/turf/open/floor/mineral/bananium,
/area/survivalpod)
"sT" = (
/obj/machinery/door/airlock/clockwork/brass,
/turf/open/floor/clockwork/reebe,
/area/survivalpod)
"te" = (
/obj/structure/alien/weeds/node,
/obj/machinery/door/airlock/plasma,
/obj/structure/alien/weeds,
/obj/machinery/light/floor,
/turf/open/floor/grass/fakebasalt,
/area/survivalpod)
"ty" = (
/obj/structure/table/wood,
/obj/item/toy/crayon/spraycan{
	pixel_y = 9
	},
/obj/item/toy/crayon/spraycan{
	pixel_x = -5;
	pixel_y = 3
	},
/obj/item/toy/crayon/spraycan{
	pixel_x = 6;
	pixel_y = 3
	},
/turf/open/floor/wood,
/area/survivalpod)
"uh" = (
/obj/effect/turf_decal/tile/yellow,
/obj/effect/turf_decal/tile/yellow{
	dir = 1
	},
/obj/effect/turf_decal/tile/yellow{
	dir = 4
	},
/obj/effect/turf_decal/tile/yellow{
	dir = 8
	},
/obj/effect/turf_decal/tile/yellow{
	dir = 8
	},
/obj/effect/turf_decal/tile/yellow{
	dir = 8
	},
/obj/effect/turf_decal/tile/yellow{
	dir = 4
	},
/obj/effect/turf_decal/tile/yellow{
	dir = 4
	},
/obj/structure/table/wood/fancy/royalblack,
/obj/item/bikehorn{
	pixel_x = -6;
	pixel_y = 10
	},
/turf/open/floor/noslip,
/area/survivalpod)
"un" = (
/obj/item/stack/ore/bananium,
/obj/machinery/light{
	dir = 1
	},
/turf/open/floor/mineral/bananium,
/area/survivalpod)
"ur" = (
/obj/structure/showcase/horrific_experiment,
/turf/open/floor/plating/abductor,
/area/survivalpod)
"uA" = (
/obj/structure/window/reinforced{
	dir = 4
	},
/obj/structure/table/wood/fancy/red,
/obj/item/soulstone,
/turf/open/floor/mineral/plastitanium/red,
/area/survivalpod)
"uD" = (
/obj/effect/turf_decal/siding/wood/corner{
	dir = 8
	},
/turf/open/floor/carpet,
/area/survivalpod)
"uN" = (
/turf/open/floor/mineral/plasma,
/area/survivalpod)
"uP" = (
/obj/effect/turf_decal/tile/yellow,
/obj/effect/turf_decal/tile/yellow{
	dir = 1
	},
/obj/effect/turf_decal/tile/yellow{
	dir = 4
	},
/obj/effect/turf_decal/tile/yellow{
	dir = 8
	},
/obj/effect/turf_decal/tile/yellow{
	dir = 8
	},
/obj/effect/turf_decal/tile/yellow{
	dir = 8
	},
/obj/effect/turf_decal/tile/yellow{
	dir = 4
	},
/obj/effect/turf_decal/tile/yellow{
	dir = 4
	},
/obj/structure/table/wood/fancy/royalblack,
/obj/item/bikehorn/golden{
	pixel_x = -6;
	pixel_y = 9
	},
/turf/open/floor/noslip,
/area/survivalpod)
"vI" = (
/obj/structure/fireplace,
/turf/open/floor/wood,
/area/survivalpod)
"vT" = (
/obj/item/stack/ore/bananium,
/turf/open/floor/mineral/bananium,
/area/survivalpod)
"wH" = (
/obj/effect/decal/cleanable/blood/gibs{
	pixel_x = -4;
	pixel_y = 12
	},
/obj/effect/decal/remains/human,
/turf/open/floor/plating/abductor,
/area/survivalpod)
"wJ" = (
/mob/living/simple_animal/butterfly,
/obj/machinery/light{
	dir = 4
	},
/turf/open/floor/grass/fairy/green,
/area/survivalpod)
"xc" = (
/obj/effect/spawner/structure/window/reinforced,
/turf/open/floor/carpet/cyan,
/area/survivalpod)
"xp" = (
/obj/machinery/light/small{
	dir = 8
	},
/obj/structure/flora/rock/pile/icy,
/turf/open/floor/grass/snow,
/area/survivalpod)
"xD" = (
/obj/structure/easel,
/obj/item/canvas/twentythreeXtwentythree,
/turf/open/floor/wood,
/area/survivalpod)
"xR" = (
/obj/machinery/portable_atmospherics/canister/toxins,
/turf/open/floor/mineral/plasma,
/area/survivalpod)
"yx" = (
/obj/structure/alien/weeds/node,
/obj/structure/bed/nest,
/obj/structure/alien/weeds,
/obj/structure/alien/weeds,
/turf/open/floor/grass/fakebasalt,
/area/survivalpod)
"zn" = (
/obj/structure/table/wood,
/obj/item/flashlight/lamp/green{
	pixel_x = -6;
	pixel_y = 3
	},
/obj/item/pen{
	pixel_x = 4;
	pixel_y = 2
	},
/turf/open/floor/wood,
/area/survivalpod)
"zv" = (
/obj/machinery/light{
	dir = 1
	},
/turf/open/floor/plating/abductor,
/area/survivalpod)
"zP" = (
/obj/effect/turf_decal/siding/wood{
	dir = 8
	},
/turf/open/floor/carpet,
/area/survivalpod)
"zX" = (
/obj/structure/chair/office/dark{
	dir = 4
	},
/obj/item/extinguisher,
/turf/open/floor/white,
/area/survivalpod)
"Aj" = (
/obj/structure/table/wood/fancy,
/obj/item/reagent_containers/food/snacks/cheesewedge/american,
/obj/item/reagent_containers/food/snacks/cheesewedge/feta{
	pixel_x = 6;
	pixel_y = 8
	},
/obj/item/reagent_containers/food/snacks/cheesewedge/parmesan{
	pixel_x = -6;
	pixel_y = 9
	},
/turf/open/floor/carpet/orange,
/area/survivalpod)
"AJ" = (
/obj/structure/chair/office/dark{
	dir = 4
	},
/obj/item/extinguisher,
/turf/open/floor/wood,
/area/survivalpod)
"AL" = (
/turf/closed/wall/mineral/wood/nonmetal,
/area/survivalpod)
"AV" = (
/obj/structure/window/reinforced{
	dir = 1
	},
/obj/structure/table/wood/fancy/red,
/obj/structure/window/reinforced{
	dir = 8
	},
/obj/item/clothing/suit/cultrobes,
/obj/item/clothing/shoes/cult,
/turf/open/floor/mineral/plastitanium/red,
/area/survivalpod)
"BH" = (
/obj/structure/reagent_dispensers/watertank,
/turf/open/floor/wood,
/area/survivalpod)
"Ce" = (
/obj/structure/table/bananium,
/obj/structure/window/plasma/reinforced{
	dir = 4
	},
/obj/structure/window/plasma/reinforced,
/obj/item/grenade/spawnergrenade/clown,
/turf/open/floor/mineral/bananium,
/area/survivalpod)
"Cj" = (
/obj/structure/bookcase/random/adult,
/turf/open/floor/carpet,
/area/survivalpod)
"Ct" = (
/obj/machinery/light,
/turf/open/floor/mineral/plasma,
/area/survivalpod)
"Cz" = (
/obj/machinery/light,
/turf/open/floor/mineral/bananium,
/area/survivalpod)
"Df" = (
/obj/structure/table/wood/fancy,
/obj/item/reagent_containers/food/snacks/cracker,
/obj/item/reagent_containers/food/snacks/cracker,
/obj/item/reagent_containers/food/snacks/cracker,
/turf/open/floor/carpet/orange,
/area/survivalpod)
"DQ" = (
/obj/machinery/light,
/turf/open/floor/clockwork/reebe,
/area/survivalpod)
"DZ" = (
/obj/effect/rune/teleport,
/turf/open/floor/mineral/plastitanium/red,
/area/survivalpod)
"Eb" = (
/turf/closed/wall/mineral/abductor,
/area/survivalpod)
"Ep" = (
/obj/structure/table/bananium,
/obj/structure/window/plasma/reinforced,
/obj/structure/window/plasma/reinforced{
	dir = 8
	},
/obj/item/gun/magic/staff/honk,
/turf/open/floor/mineral/bananium,
/area/survivalpod)
"EH" = (
/obj/structure/table/wood/fancy/red,
/obj/structure/window/reinforced{
	dir = 1
	},
/obj/item/tome,
/turf/open/floor/mineral/plastitanium/red,
/area/survivalpod)
"EK" = (
/obj/structure/chair/wood{
	dir = 4
	},
/turf/open/floor/wood,
/area/survivalpod)
"EW" = (
/turf/closed/wall/mineral/bronze,
/area/survivalpod)
"Fi" = (
/obj/machinery/porta_turret/lasertag/red,
/turf/open/floor/circuit/green,
/area/survivalpod)
"Fn" = (
/obj/structure/flora/rock,
/turf/open/floor/grass/fairy/green,
/area/survivalpod)
"FI" = (
/obj/effect/spawner/structure/window/reinforced,
/turf/open/floor/black,
/area/survivalpod)
"FQ" = (
/obj/structure/noticeboard{
	pixel_y = 32
	},
/turf/open/floor/clockwork/reebe,
/area/survivalpod)
"FU" = (
/obj/structure/alien/weeds/node,
/obj/structure/alien/weeds,
/obj/structure/alien/egg/burst,
/turf/open/floor/grass/fakebasalt,
/area/survivalpod)
"GA" = (
/obj/effect/rune/narsie{
	color = "#ff0000";
	used = 1
	},
/obj/effect/decal/remains/human,
/turf/open/floor/mineral/plastitanium/red,
/area/survivalpod)
"GB" = (
/obj/structure/table/wood/fancy,
/obj/item/reagent_containers/food/snacks/store/cheesewheel/mozzarella,
/obj/machinery/light,
/turf/open/floor/carpet/orange,
/area/survivalpod)
"GH" = (
/turf/open/floor/grass/snow,
/area/survivalpod)
"GX" = (
/obj/item/radio/intercom/ratvar{
	pixel_x = -32
	},
/obj/structure/chair/brass{
	dir = 8
	},
/turf/open/floor/clockwork/reebe,
/area/survivalpod)
"Hj" = (
/obj/item/weldingtool/experimental,
/obj/machinery/portable_atmospherics/canister/tritium,
/turf/open/floor/mineral/plasma,
/area/survivalpod)
"HX" = (
/obj/structure/chair/office/dark{
	dir = 4
	},
/obj/item/extinguisher,
/obj/effect/turf_decal/tile/red{
	dir = 1
	},
/obj/effect/turf_decal/tile/red{
	dir = 4
	},
/obj/effect/turf_decal/tile/red,
/obj/effect/turf_decal/tile/red{
	dir = 8
	},
/turf/open/floor/white,
/area/survivalpod)
"Ig" = (
/turf/closed/wall/mineral/plasma,
/area/survivalpod)
"Ip" = (
/obj/structure/alien/weeds,
/turf/open/floor/grass/fakebasalt,
/area/survivalpod)
"Ix" = (
/obj/structure/table/wood/fancy,
/obj/item/reagent_containers/food/snacks/store/cheesewheel/blue,
/obj/machinery/light{
	dir = 1
	},
/turf/open/floor/carpet/orange,
/area/survivalpod)
"IE" = (
/obj/structure/closet/abductor,
/obj/item/wirecutters/abductor,
/obj/item/weldingtool/abductor,
/obj/machinery/light,
/turf/open/floor/plating/abductor,
/area/survivalpod)
"JW" = (
/obj/effect/decal/cleanable/blood/gibs/torso,
/turf/open/floor/plating/abductor,
/area/survivalpod)
"Kd" = (
/obj/structure/barricade/wooden/crude/snow,
/turf/closed/wall/mineral/wood/nonmetal,
/area/survivalpod)
"Kk" = (
/obj/machinery/door/airlock/diamond,
/turf/open/floor/plating/abductor,
/area/survivalpod)
"Kr" = (
/obj/machinery/abductor/console,
/turf/open/floor/plating/abductor,
/area/survivalpod)
"KC" = (
/obj/structure/noticeboard{
	pixel_y = 32
	},
/obj/machinery/door/airlock/clockwork/brass,
/turf/open/floor/clockwork/reebe,
/area/survivalpod)
"KK" = (
/obj/effect/overlay/palmtree_l,
/turf/open/floor/grass/fairy/green,
/area/survivalpod)
"Lm" = (
/obj/structure/alien/weeds/node,
/obj/structure/alien/weeds,
/obj/machinery/door/airlock/research,
/obj/machinery/light/floor,
/obj/structure/alien/weeds,
/turf/open/floor/grass/fakebasalt,
/area/survivalpod)
"Lo" = (
/turf/closed/wall/mineral/bananium,
/area/survivalpod)
"Lz" = (
/obj/item/weldingtool/experimental,
/turf/open/floor/mineral/plasma,
/area/survivalpod)
"MR" = (
/turf/closed/wall/mineral/gold,
/area/survivalpod)
"Na" = (
/obj/effect/decal/remains/human,
/turf/open/floor/mineral/plastitanium/red,
/area/survivalpod)
"Ng" = (
/obj/structure/alien/weeds/node,
/obj/structure/alien/weeds,
/turf/open/floor/grass/fakebasalt,
/area/survivalpod)
"Ny" = (
/obj/structure/chair/office/dark{
	dir = 4
	},
/obj/item/extinguisher,
/turf/open/floor/carpet/cyan,
/area/survivalpod)
"Nz" = (
/obj/structure/table/wood/fancy/red,
/obj/structure/window/reinforced{
	dir = 8
	},
/obj/item/melee/cultblade,
/turf/open/floor/mineral/plastitanium/red,
/area/survivalpod)
"OM" = (
/turf/open/floor/clockwork/reebe,
/area/survivalpod)
"Pc" = (
/obj/structure/table/wood/fancy,
/obj/item/reagent_containers/food/snacks/store/cheesewheel/american,
/turf/open/floor/carpet/orange,
/area/survivalpod)
"Pm" = (
/obj/machinery/door/window{
	dir = 8;
	name = "High-Risk Modules"
	},
/obj/effect/spawner/lootdrop/aimodule_harmful,
/obj/effect/spawner/lootdrop/aimodule_harmful,
/turf/open/floor/circuit/green,
/area/survivalpod)
"Ps" = (
/obj/machinery/door/airlock/plasma,
/turf/open/floor/mineral/plasma,
/area/survivalpod)
"PX" = (
/obj/machinery/door/airlock/cult,
/turf/open/floor/mineral/plastitanium/red,
/area/survivalpod)
"Qv" = (
/obj/effect/turf_decal/tile/yellow,
/obj/effect/turf_decal/tile/yellow{
	dir = 1
	},
/obj/effect/turf_decal/tile/yellow{
	dir = 4
	},
/obj/effect/turf_decal/tile/yellow{
	dir = 8
	},
/obj/effect/turf_decal/tile/yellow{
	dir = 8
	},
/obj/effect/turf_decal/tile/yellow{
	dir = 8
	},
/obj/effect/turf_decal/tile/yellow{
	dir = 4
	},
/obj/effect/turf_decal/tile/yellow{
	dir = 4
	},
/obj/structure/table/wood/fancy/royalblack,
/obj/item/bikehorn/airhorn,
/turf/open/floor/noslip,
/area/survivalpod)
"Qy" = (
/obj/effect/spawner/lootdrop/clockcult,
/obj/structure/noticeboard{
	pixel_y = 32
	},
/turf/open/floor/clockwork/reebe,
/area/survivalpod)
"QD" = (
/obj/machinery/light/floor,
/turf/open/floor/circuit/green,
/area/survivalpod)
"RB" = (
/obj/effect/spawner/structure/window/reinforced,
/turf/open/floor/wood,
/area/survivalpod)
"RN" = (
/turf/closed/wall/mineral/cult,
/area/survivalpod)
"Sv" = (
/obj/structure/destructible/cult/pylon,
/turf/open/floor/mineral/plastitanium/red,
/area/survivalpod)
"SK" = (
/obj/item/restraints/legcuffs/beartrap,
/turf/open/floor/grass/snow,
/area/survivalpod)
"SL" = (
/obj/structure/fluff/grave,
/turf/open/floor/grass/snow,
/area/survivalpod)
"SQ" = (
/obj/structure/fluff/fokoff_sign,
/obj/item/restraints/legcuffs/beartrap,
/turf/open/floor/grass/snow,
/area/survivalpod)
"SV" = (
/obj/structure/table/abductor,
/obj/item/stack/sheet/mineral/abductor,
/obj/structure/window/paperframe,
/turf/open/floor/plating/abductor,
/area/survivalpod)
"Tm" = (
/obj/machinery/light{
	dir = 1
	},
/turf/open/floor/carpet,
/area/survivalpod)
"Tp" = (
/mob/living/simple_animal/butterfly,
/obj/machinery/light{
	dir = 8
	},
/turf/open/floor/grass/fairy/green,
/area/survivalpod)
"Tw" = (
/obj/structure/chair/brass{
	dir = 4
	},
/turf/open/floor/clockwork/reebe,
/area/survivalpod)
"TE" = (
/obj/effect/rune/convert,
/turf/open/floor/mineral/plastitanium/red,
/area/survivalpod)
"TX" = (
/obj/item/stack/ore/bananium,
/obj/machinery/light,
/turf/open/floor/mineral/bananium,
/area/survivalpod)
"Un" = (
/obj/item/reagent_containers/food/snacks/grown/banana,
/turf/open/floor/mineral/bananium,
/area/survivalpod)
"Ux" = (
/obj/structure/reagent_dispensers/watertank,
/turf/open/floor/white,
/area/survivalpod)
"Uz" = (
/obj/structure/displaycase/trophy,
/turf/open/floor/carpet,
/area/survivalpod)
"UY" = (
/turf/open/floor/circuit/green,
/area/survivalpod)
"Vb" = (
/obj/structure/table/wood/fancy,
/obj/item/reagent_containers/food/snacks/cheesewedge/american{
	pixel_x = 7;
	pixel_y = 12
	},
/obj/item/reagent_containers/food/snacks/cheesewedge/mozzarella{
	pixel_x = -2;
	pixel_y = 4
	},
/obj/item/reagent_containers/food/snacks/cheesewedge/blue{
	pixel_x = 5;
	pixel_y = 1
	},
/turf/open/floor/carpet/orange,
/area/survivalpod)
"Vh" = (
/obj/machinery/abductor/gland_dispenser,
/turf/open/floor/plating/abductor,
/area/survivalpod)
"VE" = (
/obj/structure/bookcase/random/nonfiction,
/turf/open/floor/carpet,
/area/survivalpod)
"VL" = (
/obj/effect/mob_spawn/human/plasmaman,
/turf/open/floor/mineral/plasma,
/area/survivalpod)
"VW" = (
/obj/effect/turf_decal/siding/wood,
/obj/structure/chair/comfy/black,
/turf/open/floor/carpet,
/area/survivalpod)
"Wz" = (
/obj/structure/mecha_wreckage/honker{
	anchored = 1
	},
/turf/open/floor/mineral/bananium,
/area/survivalpod)
"WW" = (
/obj/structure/window/reinforced{
	dir = 8
	},
/obj/structure/table/wood/fancy/red,
/obj/item/melee/cultblade/dagger,
/turf/open/floor/mineral/plastitanium/red,
/area/survivalpod)
"Xl" = (
/obj/item/radio/intercom/ratvar{
	pixel_x = 32
	},
/turf/open/floor/clockwork/reebe,
/area/survivalpod)
"Xy" = (
/obj/structure/window/reinforced{
	dir = 4
	},
/obj/structure/table/wood/fancy/red,
/obj/item/clothing/suit/cultrobes,
/obj/item/clothing/shoes/cult,
/turf/open/floor/mineral/plastitanium/red,
/area/survivalpod)
"XF" = (
/obj/effect/turf_decal/tile/yellow,
/obj/effect/turf_decal/tile/yellow{
	dir = 1
	},
/obj/effect/turf_decal/tile/yellow{
	dir = 4
	},
/obj/effect/turf_decal/tile/yellow{
	dir = 8
	},
/obj/effect/turf_decal/tile/yellow{
	dir = 8
	},
/obj/effect/turf_decal/tile/yellow{
	dir = 8
	},
/obj/effect/turf_decal/tile/yellow{
	dir = 4
	},
/obj/effect/turf_decal/tile/yellow{
	dir = 4
	},
/obj/structure/table/wood/fancy/royalblack,
/obj/item/reagent_containers/food/drinks/trophy/gold_cup{
	pixel_x = -5;
	pixel_y = 11
	},
/obj/item/reagent_containers/food/drinks/trophy/silver_cup{
	pixel_x = 12;
	pixel_y = 12
	},
/turf/open/floor/noslip,
/area/survivalpod)
"XG" = (
/obj/structure/table/wood/fancy/red,
/obj/item/clothing/suit/space/hardsuit/cult,
/turf/open/floor/mineral/plastitanium/red,
/area/survivalpod)
"Yq" = (
/mob/living/simple_animal/butterfly,
/turf/open/floor/grass/fairy/green,
/area/survivalpod)
"Yr" = (
/obj/structure/table/wood/fancy,
/obj/item/reagent_containers/food/snacks/cheesewedge/blue{
	pixel_x = -3;
	pixel_y = 9
	},
/obj/item/reagent_containers/food/snacks/cheesewedge/feta{
	pixel_x = 3;
	pixel_y = 7
	},
/obj/item/reagent_containers/food/snacks/cheesewedge/cheddar,
/obj/machinery/light{
	dir = 1
	},
/turf/open/floor/carpet/orange,
/area/survivalpod)
"YA" = (
/obj/structure/window/plastitanium,
/turf/open/floor/mineral/plasma,
/area/survivalpod)
"YE" = (
/obj/machinery/door/airlock/bananium,
/obj/item/grown/bananapeel,
/turf/open/floor/mineral/bananium,
/area/survivalpod)
"YN" = (
/obj/item/aiModule/supplied/freeform,
/turf/open/floor/circuit/green,
/area/survivalpod)
"YX" = (
/obj/structure/window/reinforced{
	dir = 4
	},
/obj/structure/window/reinforced{
	dir = 1
	},
/obj/structure/table/wood/fancy/red,
/obj/item/melee/cultblade/dagger,
/turf/open/floor/mineral/plastitanium/red,
/area/survivalpod)
"Zj" = (
/obj/effect/turf_decal/tile/yellow,
/obj/effect/turf_decal/tile/yellow{
	dir = 1
	},
/obj/effect/turf_decal/tile/yellow{
	dir = 4
	},
/obj/effect/turf_decal/tile/yellow{
	dir = 8
	},
/obj/effect/turf_decal/tile/yellow{
	dir = 8
	},
/obj/effect/turf_decal/tile/yellow{
	dir = 8
	},
/obj/effect/turf_decal/tile/yellow{
	dir = 4
	},
/obj/effect/turf_decal/tile/yellow{
	dir = 4
	},
/turf/open/floor/noslip,
/area/survivalpod)
"Zv" = (
/turf/open/floor/carpet,
/area/survivalpod)
"ZB" = (
/mob/living/simple_animal/butterfly,
/obj/structure/flora/rock,
/turf/open/floor/grass/fairy/green,
/area/survivalpod)
"ZF" = (
/obj/structure/fluff/fokoff_sign,
/turf/open/floor/grass/snow,
/area/survivalpod)

(1,1,1) = {"
hh
hh
bq
kc
RN
Cj
VE
bp
zn
"}
(2,1,1) = {"
gb
eU
eU
eU
PX
Zv
Zv
VW
dB
"}
(3,1,1) = {"
gm
Na
GA
Na
PX
Zv
Zv
VW
dg
"}
(4,1,1) = {"
fK
Na
Na
Na
RN
Zv
Zv
bh
ty
"}
(5,1,1) = {"
hY
AV
Nz
WW
RN
Tm
Zv
VW
xD
"}
(6,1,1) = {"
fK
EH
Sv
XG
RN
Uz
Zv
bh
aa
"}
(7,1,1) = {"
fK
YX
uA
Xy
RN
Uz
Zv
uD
zP
"}
(8,1,1) = {"
gm
fK
Na
DZ
RN
Uz
Zv
Zv
Zv
"}
(9,1,1) = {"
Na
TE
fK
fK
RN
Uz
Zv
Zv
Zv
"}
(10,1,1) = {"
MR
dZ
dZ
MR
MR
EW
sT
sT
EW
"}
(11,1,1) = {"
rP
oS
oS
rP
eC
Qy
OM
OM
OM
"}
(12,1,1) = {"
Df
oS
oS
Df
eC
hE
ac
ac
OM
"}
(13,1,1) = {"
Ix
bE
oS
gd
eC
FQ
OM
OM
OM
"}
(14,1,1) = {"
Vb
oS
oS
Aj
MR
EW
ac
sG
ho
"}
(15,1,1) = {"
Df
oS
oS
Df
MR
GX
OM
Xl
Tw
"}
(16,1,1) = {"
Pc
oS
oS
nL
MR
OM
DQ
EW
ac
"}
(17,1,1) = {"
Yr
oS
bE
GB
eC
FQ
sG
OM
ho
"}
(18,1,1) = {"
Df
oS
oS
Df
eC
FQ
OM
OM
fW
"}
(19,1,1) = {"
rP
oS
oS
rP
eC
KC
sT
sT
sT
"}
(20,1,1) = {"
Lo
kX
YE
Lo
Lo
ix
ix
ix
ix
"}
(21,1,1) = {"
Ce
ad
ad
sR
Lo
Zj
Zj
uh
Qv
"}
(22,1,1) = {"
un
dr
Un
TX
Lo
Zj
Zj
Zj
Zj
"}
(23,1,1) = {"
ad
ad
Wz
Wz
Lo
XF
ix
ix
Zj
"}
(24,1,1) = {"
dr
Wz
dr
vT
Lo
fn
ix
ix
Zj
"}
(25,1,1) = {"
ad
dr
ad
ad
Lo
Zj
Zj
Zj
Zj
"}
(26,1,1) = {"
ad
ad
Wz
ad
Lo
Zj
Qv
uP
Zj
"}
(27,1,1) = {"
un
Wz
ad
Cz
Lo
ix
ix
ix
ix
"}
(28,1,1) = {"
Ep
ad
dr
bd
Lo
FI
RB
xc
oV
"}
(29,1,1) = {"
nt
YE
YE
nt
Lo
BH
nf
cy
Ux
"}
(30,1,1) = {"
kG
gA
gA
Tp
cO
AJ
Ny
HX
zX
"}
(31,1,1) = {"
gA
gA
gA
Fn
cO
FI
RB
xc
oV
"}
(32,1,1) = {"
Yq
KK
gA
gA
cO
QD
QD
QD
QD
"}
(33,1,1) = {"
gA
Yq
Yq
gA
cO
UY
QD
QD
YN
"}
(34,1,1) = {"
ZB
gA
gA
KK
cO
UY
bg
QD
UY
"}
(35,1,1) = {"
gA
gA
gA
gA
cO
UY
QD
QD
UY
"}
(36,1,1) = {"
gA
sC
Yq
gA
cO
oF
oh
pH
Pm
"}
(37,1,1) = {"
gA
Yq
Fn
Yq
cO
UY
QD
QD
UY
"}
(38,1,1) = {"
gA
gA
gA
gA
cO
UY
QD
QD
UY
"}
(39,1,1) = {"
wJ
gA
gA
rV
cO
Fi
QD
QD
Fi
"}
(40,1,1) = {"
Eb
Kk
Kk
Eb
Kd
cO
nU
nU
cO
"}
(41,1,1) = {"
Kr
jb
jb
jb
Kd
GH
ZF
GH
xp
"}
(42,1,1) = {"
jb
jb
jb
Vh
Kd
hQ
no
SQ
GH
"}
(43,1,1) = {"
JW
IE
Eb
Eb
Kd
fE
EK
GH
GH
"}
(44,1,1) = {"
em
pY
jb
SV
AL
vI
hQ
rl
GH
"}
(45,1,1) = {"
sO
qw
wH
jb
Kd
si
hQ
GH
eA
"}
(46,1,1) = {"
ax
jb
jb
jb
Kd
rc
GH
GH
GH
"}
(47,1,1) = {"
Eb
Eb
Eb
zv
Kd
GH
SK
no
GH
"}
(48,1,1) = {"
ur
jb
jb
jb
Kd
SL
GH
GH
no
"}
(49,1,1) = {"
jb
pV
jb
jb
Kd
GH
GH
GH
GH
"}
(50,1,1) = {"
Ps
Ps
Ps
Ps
Ig
aI
Lm
Lm
aI
"}
(51,1,1) = {"
uN
uN
uN
uN
Ig
Ng
Ng
qe
Ip
"}
(52,1,1) = {"
VL
uN
YA
YA
Ig
FU
pA
pA
Ip
"}
(53,1,1) = {"
uN
Ct
YA
Hj
Ig
Ng
pA
jO
Ip
"}
(54,1,1) = {"
uN
uN
YA
YA
Ig
kz
pA
Ip
qe
"}
(55,1,1) = {"
uN
uN
uN
uN
Ig
Ip
pA
Ip
pA
"}
(56,1,1) = {"
YA
YA
uN
uN
te
Ip
pA
Ip
Ng
"}
(57,1,1) = {"
rS
YA
hg
uN
te
pA
pA
pA
Ng
"}
(58,1,1) = {"
Lz
YA
uN
uN
te
Ng
Ng
kz
Ng
"}
(59,1,1) = {"
xR
YA
uN
uN
te
yx
yx
yx
yx
"}
